{
	"tile_path": "assets/tiles.png",
	"rows": 20,
	"columns": 20,
	"width": 40,
	"height": 40,
	"cells": [ 
				{ "type": "block", "point": [0, 0] },
				{ "type": "block", "point": [40, 0] },
				{ "type": "block", "point": [80, 0] },
				{ "type": "block", "point": [0, 40] },
				{ "type": "block", "point": [40, 40] },
				{ "type": "block", "point": [80, 40] },
				{ "type": "block", "point": [0, 80] },
				{ "type": "block", "point": [40, 80] },
				{ "type": "block", "point": [80, 80] },
				{ "type": "block", "point": [0, 120] },
				{ "type": "block", "point": [40, 120] },
				{ "type": "block", "point": [80, 120] },
				{ "type": "block", "point": [120, 120] },
				{ "type": "block", "point": [160, 120] },
				{ "type": "block", "point": [0, 160] },
				{ "type": "block", "point": [40, 160] },
				{ "type": "block", "point": [80, 160] },
				{ "type": "block", "point": [120, 160] },
				{ "type": "block", "point": [160, 160] },
				{ "type": "block", "point": [0, 200] },
				{ "type": "block", "point": [40, 200] },
				{ "type": "block", "point": [80, 200] },
				{ "type": "block", "point": [120, 200] },
				{ "type": "block", "point": [160, 200] }, 
				{ "type": "spike_1", "point": [120, 0] },
				{ "type": "spike_2", "point": [160, 0] },
				{ "type": "door_open", "point": [120, 40] },
				{ "type": "spike_2", "point": [160, 40] } 
				],
	
	"level_data": [
					13, -1, -1, -1, -1, -1, -1, -1, -1, -1, -1, -1, -1, -1, -1, -1, -1, -1, -1, 13, 
					18, -1, -1, -1, -1, -1, -1, -1, -1, -1, -1, -1, -1, -1, -1, -1, -1, -1, -1, 18, 
					18, -1, -1, -1, -1, -1, -1, -1, -1, -1, -1, -1, -1, -1, -1, -1, -1, -1, -1, 18,  
					18, -1, -1, -1, -1, -1, -1, -1, -1, -1, -1, -1, -1, -1, -1, -1, -1, -1, -1, 18, 
					18, -1, -1, -1, -1, -1, -1, -1, -1, -1, -1, -1, -1, -1, -1, -1, -1, -1, -1, 18, 
					18, -1, -1, -1, -1, -1, -1, -1, -1, -1, -1, -1, -1, -1, -1, -1, -1, -1, -1, 18, 
					18, -1, -1, -1, -1, -1, -1, -1, -1, -1, -1, -1, -1, -1, -1, -1, -1, -1, -1, 18, 
					18, -1, -1, -1, -1, -1, -1, -1, -1, -1, -1, -1, -1, -1, -1, -1, -1, -1, -1, 18,  
					18, -1, -1, -1, -1, -1, -1, -1, -1, -1, -1, -1, -1, -1, -1, -1, -1, -1, -1, 18, 
					18, -1, -1, -1, -1, -1, -1, -1, -1, -1, -1, -1, -1, -1, -1, -1, -1, -1, -1, 18,  
					18, -1, -1, -1, -1, -1, -1, -1, -1, -1, -1, -1, -1, -1, -1, -1, -1, -1, -1, 18, 
					18, -1, -1, -1, -1, -1, -1, -1, -1, -1, -1, -1, -1, -1, -1, -1, -1, -1, -1, 18, 
					18, -1, -1, -1, -1, -1, -1, -1, -1, -1, -1, -1, -1, -1, -1, -1, -1, -1, -1, 18,  
					18, -1, -1, -1, -1, -1, -1, -1, -1, -1, -1, -1, -1, -1, -1, -1, -1, -1, -1, 18, 
					18, -1, -1, -1, -1, -1, -1, -1, -1, -1, -1, -1, -1, -1, -1, -1, -1, -1, -1, 18, 
					18, -1, -1, -1, -1, -1, -1, -1, -1, -1, -1, -1, -1, -1, -1, -1, -1, -1, -1, 18, 
					18, -1, -1, -1, -1, -1, -1, -1, -1, -1, -1, -1, -1, -1, -1, -1, -1, -1, -1, 18, 
					18, -1, -1, -1, -1, -1, -1, -1, -1, -1, -1, -1, -1, -1, -1, -1, -1, -1, -1, 18,  
					23, -1, -1, -1, -1, -1, -1, -1, -1, -1, -1, -1, -1, -1, -1, -1, -1, -1, -1, 23, 
					 9, 10, 10, 10, 10, 10, 10, 10, 10, 10, 10, 10, 10, 10, 10, 10, 10, 10, 10,  9
					]
}